CNN Explainer: Learning Convolutional Neural Networks with Interactive Visualization
PipelineProfiler: A Visual Analytics Tool for the Exploration of AutoML Pipelines
PassVizor: Toward Better Understanding of the Dynamics of Soccer Passes
P6: A Declarative Language for Integrating Machine Learning in Visual Analytics
Boba: Authoring and Visualizing Multiverse Analyses
Uplift: A Tangible and Immersive Tabletop System for Casual Collaborative Visual Analytics
DECE: Decision Explorer with Counterfactual Explanations for Machine Learning Models
VizCommender: Computing Text-Based Similarity in Visualization Repositories for Content-Based Recommendations
A Visual Analytics Framework for Reviewing Multivariate Time-Series Data with Dimensionality Reduction
Auditing the Sensitivity of Graph-based Ranking with Visual Analytics
Integrating Prior Knowledge in Mixed-Initiative Social Network Clustering
Once Upon A Time In Visualization: Understanding the Use of Textual Narratives for Causality
Supporting the Problem-Solving Loop: Designing Highly Interactive Optimisation Systems
Revisiting the Modifiable Areal Unit Problem in Deep Traffic Prediction with Visual Analytics
Preserving Minority Structures in Graph Sampling
Selection-Bias-Corrected Visualization via Dynamic Reweighting
Towards Better Bus Networks: A Visual Analytics Approach
A Visual Analytics Framework for Explaining and Diagnosing Transfer Learning Processes
An Examination of Grouping and Spatial Organization Tasks for High-Dimensional Data Exploration
Argus: Interactive a priori Power Analysis
A Visual Analytics Approach for Ecosystem Dynamics based on Empirical Dynamic Modeling
A Visual Analytics Approach for Exploratory Causal Analysis: Exploration, Validation, and Applications
Attention Flows: Analyzing and Comparing Attention Mechanisms in Language Models
Visual cohort comparison for spatial single-cell omics-data
QLens: Visual Analytics of MUlti-step Problem-solving Behaviors for Improving Question Design
VATLD: A Visual Analytics System to Assess, Understand and Improve Traffic Light Detection
StackGenVis: Alignment of Data, Algorithms, and Models for Stacking Ensemble Learning Using Performance Metrics
Explainable Matrix - Visualization for Global and Local Interpretability of Random Forest Classification Ensembles
Visilant: Visual Support for the Exploration and Analytical Process Tracking in Criminal Investigations
CcNav: Understanding Compiler Optimizations in Binary Code
TaxThemis: Interactive Mining and Exploration of Suspicious Tax Evasion Groups
Insight Beyond Numbers: The Impact of Qualitative Factors on Visual Data Analysis
HyperTendril: Visual Analytics for User-Driven Hyperparameter Optimization of Deep Neural Networks
II-20: Intelligent and pragmatic analytic categorization of image collections
MultiSegVA: Using Visual Analytics to Segment Biologging Time Series on Multiple Scales
Multiscale Snapshots: Visual Analysis of Temporal Summaries in Dynamic Graphs
Visual Analytics for Temporal Hypergraph Model Exploration
InCorr: Interactive Data-Driven Correlation Panels for Digital Outcrop Analysis
Co-Bridges: Pair-wise Visual Connection and Comparison for Multi-item Data Streams
Githru: Visual Analytics for Understanding Software Development History Through Git Metadata Analysis
Visual Neural Decomposition to Explain Multivariate Data Sets
LineSmooth: An Analytical Framework for Evaluating the Effectiveness of Smoothing Techniques on Line Charts
Visual Analysis of Argumentation in Essays
Competing Models: Inferring Exploration Patterns and Information Relevance via Bayesian Model Selection
Evaluation of Sampling Methods for Scatterplots
In Search of Patient Zero: Visual Analytics of Pathogen Transmission Pathways in Hospitals
CAVA: A Visual Analytics System for Exploratory Columnar Data Augmentation Using Knowledge Graphs
HypoML: Visual Analysis for Hypothesis-based Evaluation of Machine Learning Models
CNNPruner: Pruning Convolutional Neural Networks with Visual Analytics
Visual Causality Analysis of Event Sequence Data
Topology Density Map for Urban Data Visualization and Analysis