The What-If Tool: Interactive Probing of Machine Learning Models
Summit: Scaling Deep Learning Interpretability by Visualizing Activation and Attribution Summarizations
Supporting Analysis of Dimensionality Reduction Results with Contrastive Learning
FairSight: Visual Analytics for Fairness in Decision Making
Visual Interaction with Deep Learning Models through Collaborative Semantic Inference
AirVis: Visual Analytics of Air Pollution Propagation
Visual Analytics for Electromagnetic Situation Awareness in Radio Monitoring and Management
PlanningVis: A Visual Analytics Approach to Production Planning in Smart Factories
explAIner: A Visual Analytics Framework for Interactive and Explainable Machine Learning
Tac-Simur: Tactic-based Simulative Visual Analytics of Table Tennis
ProtoSteer: Steering Deep Sequence Model with Prototypes
Semantic Concept Spaces: Guided Topic Model Refinement using Word-Embedding Projections
Evaluating Perceptual Bias During Geometric Scaling of Scatterplots
Ablate, Variate, and Contemplate: Visual Analytics for Discovering Neural Architectures
Selection Bias Tracking and Detailed Subset Comparison for High-Dimensional Data
VASABI: Hierarchical User Profiles for Interactive Visual User Behaviour Analytics
Interactive Learning for Identifying Relevant Tweets to Support Real-time Situational Awareness
Visual Analysis of High-Dimensional Event Sequence Data via Dynamic Hierarchical Aggregation
FlowSense: A Natural Language Interface for Visual Data Exploration within a Dataflow System
R-Map: A Map Metaphor for Visualizing Information Reposting Process in Social Media
Facetto: Combining Unsupervised and Supervised Learning for Hierarchical Phenotype Analysis in Multi-Channel Image Data
Explaining Vulnerabilities to Adversarial Machine Learning through Visual Analytics
EmoCo: Visual Analysis of Emotion Coherence in Presentation Videos
A Natural-language-based Visual Query Approach of Uncertain Human Trajectories
CloudDet: Interactive Visual Analysis of Anomalous Performances in Cloud Computing Systems
Understanding the Role of Alternatives in Data Analysis Practices
You can't always sketch what you want: Understanding Sensemaking in Visual Query Systems
GPGPU Linear Complexity t-SNE Optimization
NNVA: Neural Network Assisted Visual Analysis of Yeast Cell Polarization Simulation
GUIRO: User-Guided Matrix Reordering
Exploranative Code Quality Documents
MetricsVis: A Visual Analytics System for Evaluating Employee Performance in Public Safety Agencies
LightGuider: Guiding Interactive Lighting Design using Suggestions, Provenance, and Quality Visualization
CourtTime: Generating Actionable Insights into Tennis Matches Using Visual Analytics
VASSL: A Visual Analytics Toolkit for Social Spambot Labeling
STBins: Visual Tracking and Comparison of Multiple Data Sequences Using Temporal Binning
Scalable Topological Data Analysis and Visualization for Evaluating Data-Driven Models in Scientific Applications
sPortfolio: Stratified Visual Analysis of Stock Portfolios
The Validity, Generalizability and Feasibility of Summative Evaluation Methods in Visual Analytics
Motion Browser: Visualizing and Understanding Complex Upper Limb Movement Under Obstetrical Brachial Plexus Injuries
OD Morphing: Balancing Simplicity with Faithfulness for OD Bundling
Galex: Exploring the Evolution and Intersection of Disciplines