RetainVis: Visual Analytics with Interpretable and Interactive Recurrent Neural Networks on Electronic Medical Records
Seq2Seq-Vis: A Visual Debugging Tool for Sequence-to-Sequence Models
RuleMatrix: Visualizing and Understanding Classifiers with Rules
GAN Lab: Understanding Complex Deep Generative Models using Interactive Visual Experimentation
DQNViz: A Visual Analytics Approach to Understand Deep Q-Networks
Manifold: A Model-Agnostic Framework for Interpretation and Diagnosis of Machine Learning Models
VIS4ML: An Ontology for Visual Analytics Assisted Machine Learning
iForest: Interpreting Random Forests via Visual Analytics
Visual Abstraction of Large Scale Geospatial Origin-Destination Movement Data
ForVizor: Visualizing Spatio-Temporal Team Formations in Soccer
Evaluating Multi-Dimensional Visualizations for Understanding Fuzzy Clusters
Visual Analytics for Topic Model Optimization based on User-Steerable Speculative Execution
TPFlow: Progressive Partition and Multidimensional Pattern Extraction for Large-Scale Spatio-Temporal Data Analysis
Visual Progression Analysis of Event Sequence Data
GraphProtector: A Visual Interface for Employing and Assessing Multiple Privacy Preserving Graph Algorithms
Clustrophile 2: Guided Visual Clustering Analysis
Futzing and Moseying: Interviews with Professional Data Analysts on Exploration Practices
Analysis of Flight Variability: a Systematic Approach
A Visual Analytics Framework for the Detection of Anomalous Call Stack Trees in High Performance Computing Applications
Situ: Identifying and Explaining Suspicious Behavior in Networks
MotionRugs: Visualizing Collective Trends in Space and Time
EnsembleLens: Ensemble-based Visual Exploration of Anomaly Detection Algorithms with Multidimensional Data
SIRIUS: Dual, Symmetric, Interactive Dimension Reductions
An Interactive Method to Improve Crowdsourced Annotations
MAQUI: Interweaving Queries and Pattern Mining for Recursive Event Sequence Exploration
Visual Analysis of the Temporal Evolution of Ensemble Forecast Sensitivities
KnowledgePearls: Provenance-Based Visualization Retrieval
VIS Author Profiles: Interactive Descriptions of Publication Records Combining Text and Visualization
VIBR: Visualizing Bipartite Relations at Scale with the Minimum Description Length Principle
RegressionExplorer: Interactive Exploration of Logistic Regression Models with Subgroup Analysis
An Information-Theoretic Approach to the Cost-benefit Analysis of Visualization in Virtual Environments
Identification of Temporally Varying Areas of Interest in Long-Duration Eye-Tracking Data Sets
Drag and Track: A Direct Manipulation Interface for Contextualizing Data Instances within a Continuous Parameter Space
Duet: Helping Data Analysis Novices Conduct Pairwise Comparisons by Minimal Specification
BitExTract: Interactive Visualization for Extracting Bitcoin Exchange Intelligence
InkPlanner: Supporting Prewriting via Intelligent Visual Diagramming
Lessons Learned Developing a Visual Analytics Solution for Investigative Analysis of Scamming Activities
Vulnus: Visual Vulnerability Analysis for Network Security
A Visual Analytics Framework for Spatiotemporal Trade Network Analysis
Doccurate: A Curation-Based Approach for Clinical Text Visualization
Enhancing Web-based Analytics Applications through Provenance